112,112,112,112,112,112,112,112,112,112
111,12,12,12,12,12,12,12,12,110
111,12,12,46,46,46,46,12,12,110
111,12,12,46,12,12,46,12,12,110
34,12,12,46,46,46,46,12,12,34
34,12,12,46,12,12,46,12,12,34
34,12,12,46,12,12,46,12,12,34
34,12,12,12,12,12,12,12,12,34
34,12,12,12,12,12,12,12,12,34
109,109,109,109,109,109,109,109,109,109
